NO textures/north.xpm
SO textures/south.xpm
WE textures/west.xpm
EA textures/east.xpm

F 118,85,43
C 153,204,255
        1111111111111111111111111
        1000000000110000000000001
        1011000001110000000000001
        100100000000000000N000001
111111111011000001110000000000001
100000000011000001110111111111111
11110101111111011100000010001
11110101111111011101010010001
11000000110101011100000010001
10001000000000001100000010001
1000010100000001101010010001
1100001011010101111101111000111
11110111 1110101 101111010001
11111111 1111111 111111111111