NO textures/west.xpm
SO textures/west.xpm
WE textures/north.xpm
EA textures/north.xpm

F 254,169,20
C 153,204,255
        1111111111111111111111111
        1000000000110000000000001
        1011000001110000000000001
        1001000000000000000000001
111111111011000001110000000000001
100000000011000001110111111111111
11110101111111011100000010001
11110101111111011101010010001
11000000110101011100000010001
10000010000000001100000010001
100000N0000000001101010010001
1100000111010101111101111000111
11110111 1110101 101111010001
11111111 1111111 111111111111